#####***
#...#***
#...####
#......#
#......#
########